1111111111111111111
1000000000000000001
1010010100100000001
1010010010000101001
1P00000000E000N00C1
1111111111111111111