1111111111111111111
1000000000000000001
1010010100100010101
1010010010000010101
1P00000000E000000C1
1111111111111111111